11 11
.....#.....
.###.#..##.
.#...#..#..
.#...####.#
.#####..#..
...#.@..##.
##...#.##..
..####..#.#
..#..##.#..
.##.....##.
......#....
