9 9
...#..#..
...#..#..
#.#...#.#
#...###..
..#.@.##.
..###....
#...#####
#.#...#..
#...#....
